Shanghai	CN
Beijing	CN
Hunan	CN
Zhejiang	CN
Jiangsu	CN
JiangXi	CN
Shandong	CN
Xinjiang	CN
AnHui	CN
LiaoNing	CN
Heilongjiang	CN
Jilin	CN
ShanXi	CN
HeBei	CN
Gansu	CN
Guizhou	CN
Chongqing	CN
Xizang	CN
Guangdong	CN
Neimenggu	CN
Ningxia	CN
Membay	IN
New Delhi	IN
Istanbul	TK
Ankara	TK
Tokyo	JP
Seoul	KO
Tucson	US
Phoenix	US
